WWWWWWWWWWWWWWWWWWWWWWWWWWWWWWWWWWWWWWWWWWWWWWWWWWWWWWWWWWWW
W                            W                   WTWW      W
W                            W                   W WW      W
W                            W                   WMWW      W
W               J            H                   W WH      W
W                            W           R       WMWW      W
W                            W                   W WW   R  W
W   R                        W                   W WW      W
WWWWWWWWWWW   WWWWWWWWWWWWWWWWWWWWWWWWWWW WWWHWWWW WW      W
WWWWWWWWWWW   WWWWWWWWWWWWWWWWWW                   WW      W
WWWWWWWWWWW   WWWWWWWWWWWWWWWWWW WWWWWWWW WWWWWWWWWWW      W
WWWWWWWWWW    WWWWWWWWWWWWWWWWWW W                  W      W
WWWWWWWW     WWWWWWWWWWWWWWWWWWW W              R   W      W
WWWWWWW    WWWWWWWWWWWWWWWWWWWWW W                  W      W
WWWWWWW   WWWWWWWWWWWWWWWWWWWWWW W                  W      W
WWWWWWW   WWWWWWWWWWWWWWWWWWWWWW W                         W
WWWWWW   WWWWWWWWWWW             W                    R    W
WWWWWW   WWWWWWWWWWW WWWWWW   WWWW                         W
WWWWWW   WWWWWWWWWWW W                              W      W
W                  W W                              W      W
W                  W W                              W      W
W      R           W WWWWWWWHWWWWWWWWWWWWWWWWHWWWWWWW      W
W                  W W                W             W      W
W                                     W             W      W
WWWWWWWWWWWHWWWWWWWW W                W             W      W
WS                   W                W             W      W
WWWWWWWWWWWHWWWWWWWWWW                       R      W      W
W                                     W             W      W
W            R                        W             W      W
WWWWWWWWWWWWWWWWWWWWWWWWWWWWWWWWWWWWWWWWWWWWWWWWWWWWWWWWWWWW