WWWWWWWWWWWWWWWWWWWWWWWWWWWWWWWWWWWWWWWWWWWWWWWWWWWWWWWWWWWW
W                            W                  W M W      W
W                            W                  W   W      W
W                            W                  W M W      W
W               J            H                  W   H      W
W                            W           R      W M W      W
W                            W                  W   W   R  W
W   R                        W                  W M W      W
WWWWWWWWWWW   WWWWWWWWWWWWWWWWWWWWWWWWWWW WWWHWWW   W      W
W                                                 M W      W
WWWWWWWWWWW   WWWWWWWWWWWWWWWWWW WWWWWWWW WWWWWWWWWWW      W
WWWWWWWWWW    WWWWWWWWWWWWWWWWWW W                  W      W
WWWWWWWW     WWWWWWWWWWWWWWWWWWW W              R   W      W
WWWWWWW    WWWWWWWWWWWWWWWWWWWWW W                  W      W
WWWWWWW   WWWWWWWWWWWWWWWWWWWWWW W                  W      W
WWWWWWW   WWWWWWWWWWWWWWWWWWWWWW W                         W
WWWWWW   WWWWWWWWWWW             W                    R    W
WWWWWW   WWWWWWWWWWW WWWWWWWWWWWWW                         W
WWWWWW   WWWWWWWWWWW W                              W      W
W                  W W                              W      W
W                  W W                              W      W
W      R           W WWWWWWWWWWWWWWWWWWWWWWWWHWWWWWWW      W
W                  W W                W             W      W
W                                     W             W      W
WWWWWWWWWWWHWWWWWWWW W                W             W      W
S                    W                W             W      W
WWWWWWWWWWWHWWWWWWWWWW                       R      W      W
W                                     W             W      W
W            R                        W             W      W
WWWWWWWWWWWWWWWWWWWWWWWWWWWWWWWWWWWWWWWWWWWWWWWWWWWWWWWWWWWW