WWWWWWWWWWWWWWWWWWWWWWWWWWWWWWWWWWWWWWWWWWWWWWWWWWWWWWWWWWWW
WWWWWWWWWWWWWWWWWWWWWWWWWWWWW     WWWWWWWWWWWWWWWWWWWWWWWWWW
WWWWWWWWWWWWWWW             H     WWWWWWWWWWWWWWWWWWWWWWWWWW 
WWWWWWWWWWWWWWW WWWWWWWWWWWWW     WWWWWWWWWWWWWWWWWWWWWWWWWW
WWWWWWWWWWWWWWW WWWWWWWWWWWWW     WWWWWWWWWWWWWWWWWWWWWWWWWW
WWWWWWWWWWWWWWW WWWWWWWWWWWWWWWHWWWWWWWWWWWWWWWWWWWWWWWWWWWW
WWWWWWWW                W              WWWWWWWWWWWWWWWWWWWWW
WWWWWWWW       R        W WWWWWHWWWWWW WWWWWWWWWWWWWWWWWWWWW
WWWWWWWW                W W          W WWWWWWWWWWWWWWWWWWWWW
WWWWWWWWWWWWWWWWWWWWWWWWW W          W WWWWWWWWWWWWWWWWWWWWW
WWWWWWWWWWWWWWWWW    WWWW W          W WWWWWWWWWWWWWWWWWWWWW
S               W    W    W          W   WWWWWWWWWWWWWM M MW
WWWWWWWWWWWWWWW W    W WWWW          WWW WWWWWWWWWWWWW WWWWW
WWWWWWWWWWWWWWW W    W W               W WWWWWWWWWWWWWMWWWWW
WWWWWWWWWWWWWWW W    W H               W WWWWWWWWWWWWW WWWWW
WWWWWWWWWWWWWWW W    W W      R        W WWWWWWWWWWWWW WWWWW
WWWWWWWWWWWWWWW W    W W               W WWWWWWWWWWWWW WWWWW
WWWWWWWWWWWWWWW W  R W W               W WWWWWWWWWWWWW WWWWW
WWWWWWWWWWWWWWW W    W W               W               WWWWW
WWWWWWWWWWWWWWW W    W W               WWWWWWWWWWWWWWWWWWWWW
WWWWWWWWWWWWWWW WWWWWW WWWWWWWW WWWWWWWWWWWWWWWWWWWWWWWWWWWW
WWWWWWWWWWWWWWW        WWWWWWWW WWWWWWWWWWWWWWWWWWWWWWWWWWWW
WWWWWWWWWWWWWWWWWWHWWWWWWWWWWWW WWWWWWWWWWWWWWWWWWWWWWWWWWWW
WWWWWWWWWWWWWWWWW                      WWWWWWWWWWWWWWWWWWWWW
WWWWWWWWWWWWWWWWW                      WWWWWWWWWWWWWWWWWWWWW
WWWWWWWWWWWWWWWWW     R                WWWWWWWWWWWWWWWWWWWWW
WWWWWWWWWWWWWWWWW                      WWWWWWWWWWWWWWWWWWWWW
WWWWWWWWWWWWWWWWW                      WWWWWWWWWWWWWWWWWWWWW
WWWWWWWWWWWWWWWWW                      WWWWWWWWWWWWWWWWWWWWW
WWWWWWWWWWWWWWWWWWWWWWWWWWWWWWWWWWWWWWWWWWWWWWWWWWWWWWWWWWWW