WWWWWWWWWWWWWWWWWWWWWWWWWWWWWWWWWWWWWWWWWWWWWWWWWWWWWWWWWWWW
WWWWWWWW                   W         WMW                   W
WWWWWWWW WWWWWWWWWWWWWWWWW W         W W                   W
WWWWWWWW W               W W         WMW                   W
WWWWWWWW H               W W         W W                   W
WWWWWWWW W               W W  R      WMW                   W
WWWWWWWW W               W W         W W            R      W
S        W           R   W W         WMW                   W
WWWWWWWWWW               W W         W W                   W
W                        W W         W W                   W
W                        W W         H H      R            W
W                        W W         W W                   W
W   R                    W W         W W                   W
W                        W W         W WWWWWWWWWWWWHWWWWWWWW
W                        H H         W                     W
W                        W W         W WWWWWWWWWWWWHWWWWWWWW
WWWWWWWWWWWWWWWWWWWWW WWWW W         W W             WWWWWWW
W             WWWWWWW WWWW W         H H     J       W    WW
W          R  H       WWWW W         W W             W WW WW
W             WWWWWWW WWWW W         W WWWWWWWWWWWWWWW WW WW
W             WWWWWWW WWWW W         W                 WW WW
W      R      WWWWWWW WWWW W         WWWWWWWWWWWWWWWWWWWW WW
W             WWWWWW  WWWW W                            W WW
W        R    WWWWWW WWWWW W                            W WW
W             WWWWWWHWWWWW W                            W WW
W             W          W W                   R        W WW
W   R         W          W WWWWWWHWWWWWWWWWWWWWWWWWWWWWWW WW
W             W          H                                WW
W             W   R      WWWWWWWWWWWWWWWWWWWWWWWWWWWWWWWWWWW
WWWWWWWWWWWWWWWWWWWWWWWWWWWWWWWWWWWWWWWWWWWWWWWWWWWWWWWWWWWW