WWWWWWWWWWWWWWWWWWWWWWWWWWWWWWWWWWWWWWTWWWWWWWWWWWWWWWWWWWWW
WWWWWWWW                   W         WMWWWWWW              W
WWWWWWWW WWWWWWWWHWWWWWWWW W         W WWWWWWHWWWWWWWW   WWW
WWWWWWWW W               W W         WMW                   W
WWWWWWWW W               W W         W W                   W
WWWWWWWW W               W W  R      WMW                   W
WWWWWWWW W               W W         W W            R      W
S        W           R   W W         WMW                   W
WWWWW   WW               W W         W W                   W
W                        W W         W W                   W
W                        W W                  R            W
W                        W W                               W
W   R                                W W                   W
W                                    W WWWWWWWWWWWWWWWWWWWWW
W                                    W                     W
W                        W W         W WWWWWWHWWWWWWWWWWWWWW
WWWWWWHWWWWWWWWWWWWWWWWWWW W         W W             WWWWWWW
W             WWWWWWWWWWWW W         W W     J       W    WW
W          R          WWWW W         W W             W WW WW
W             WWWWWWW WWWW W         W WWWWWWWWWWWWWWW WW WW
W             WWWWWWW WWWW W         W                 WW WW
W      R      WWWWWWW WWWW W         WWWWWWWWWWWWWWWWWWWW WW
W             WWWWWW  WWWW W                            W WW
W        R    WWWWWW WWWWW W                            W WW
W             WWWWWWWWWWWW W                            W WW
W             W          W W                   R        W WW
W   R         W          W WWWWWWWWWWWWWWWWWWWWWWWWWWWWWW WW
W             H          W                                WW
W             W   R      WWWWWWWWWWWWWWWWWWWWWWWWWWWWWWWWWWW
WWWWWWWWWWWWWWWWWWWWWWWWWWWWWWWWWWWWWWWWWWWWWWWWWWWWWWWWWWWW