WWWWWWWWWWWWWWWWWWWWWWWWWWWWWWWWWWWWWWWWWWWWWWWWWWWWWWWWWWWW
WWWWWWWWWWWWWWWWWWWWWWWWWWWWWWWWWWWWWWWWWWWWWWWWWWWWWWWWWWWW
WTM     WWWWWWWWW                  WWWWWWWWW              WW
WWWWWWW WWWWWWWWW WWWWWWWWWWWWWWWW WWWWWWWWW WWWWWWWWWWWW WW
WWWWWWW WWWWWWWWW W              W WWWWWWWWW W          W WW
WWWWWWW WWWWWWWWW     R            WWWWWWWWW    R         WW
WWWWWWW WWWWWWWWW W R            W WWWWWWWWW W          W WW
WWWWWWW WWWWWWWWW WWWWWWWWWHWWWWWW WWWWWWWWW WWWWWWWWWHHW WW
WW                                                        WW
WW W WW WWWWWWWWW WWWWWWWWWHWWWWWW WWWWWWWWW WWWWWWWWWHHWWWW
WW W  H WWWWWWWWW W              W WWWWWWWWW H           WWW
WW W  W WWWWWWWWW W R          R W WWWWWWWWW W           WWW
WW W  W WWWWWWWWW W              W WWWWWWWWW W      J    WWW
WW W  H WWWWWWWWW H              W WWWWWWWWW W           WWW
WW WR W WWWWWWWWW W      R       W WWWWWWWWW W           WWW
WW W RW WWWWWWWWW W  R           W WWWWWWWWW W           WWW
WW W  W WWWWWWWWW W              H WWWWWWWWW H           WWW
WW W WW WWWWWWWWW WWWWWWWWWWHWWWWW WWWWWWWWW WWWWWWWWWWWWWWW
WW                                                        WW
WWWWWWW WWWWWWWWW WWWWWWWWWWHWWWWW WWWWWWWWW WWWWWWWHHWWW WW
WWWWWWW WWWWWWWWW W              W WWWWWWWWW W          W WW
WWWWWWW WWWWWWWWW    R             WWWWWWWWW    R         WW
WWWWWWW WWWWWWWWW W    R         W WWWWWWWWW W          W WW
WWWWWWW WWWWWWWWW WWWWWWWWWWWWWWWW WWWWWWWWW WWWWWWWWWWWW WW
WS                                                        WW
WWWWWWW WWWWWWWWW WWWWWWWWWWWWWWWW WWWWWWWWW WWWWWWWWWWWWWWW
WWWWWWW WWWWWWWWW WWWWWWWWWWWWWWWW WWWWWWWWW WWWWWWWWWWWWWWW
WWWWWWW           WWWWWWWWWWWWWWWW           WWWWWWWWWWWWWWW
WWWWWWWWWWWWWWWWWWWWWWWWWWWWWWWWWWWWWWWWWWWWWWWWWWWWWWWWWWWW
WWWWWWWWWWWWWWWWWWWWWWWWWWWWWWWWWWWWWWWWWWWWWWWWWWWWWWWWWWWW