WWWWWWWWWWWWWWWWWWWWWWWWWWWWWWWWWWWWWWWWWWWWWWWWWWWWWWWWWWWW
WWWWWWWWWWWWWWWWWWWWWWWWWWWWWWWWWWWWWWWWWWWWWWWWWWWWWWWWWWWW
WWM     WWWWWWWWW                  WWWWWWWWW              WW
WWWWWWW WWWWWWWWW WWWWWWWWWWWWWWWW WWWWWWWWW WWWWWWWWWWWW WW
WWWWWWW WWWWWWWWW WWWWWWWWWWWWWWWW WWWWWWWWW WWWWWWWWWWWW WW
WWWWWWW WWWWWWWWW WWWWWWWWWWWWWWWW WWWWWWWWW WWWWWWWWWWWW WW
WWWWWWW WWWWWWWWW WWWWWWWWWWWWWWWW WWWWWWWWW WWWWWWWWWWWW WW
WWWWWWW WWWWWWWWW WWWWWWWWWWWWWWWW WWWWWWWWW WWWWWWWWWWWW WW
WW                                                        WW
WW WWWW WWWWWWWWW WWWWWWWWWWWWWWWW WWWWWWWWW WWWWWWWWWWWWWWW
WW WWWW WWWWWWWWW WWWWWWWWWWWWWWWW WWWWWWWWW WWWWWWWWWWWWWWW
WW WWWW WWWWWWWWW WWWWWWWWWWWWWWWW WWWWWWWWW WWWWWWWWWWWWWWW
WW WWWW WWWWWWWWW WWWWWWWWWWWWWWWW WWWWWWWWW WWWWWWWWWWWWWWW
WW WWWW WWWWWWWWW WWWWWWWWWWWWWWWW WWWWWWWWW WWWWWWWWWWWWWWW
WW WWWW WWWWWWWWW WWWWWWWWWWWWWWWW WWWWWWWWW WWWWWWWWWWWWWWW
WW WWWW WWWWWWWWW WWWWWWWWWWWWWWWW WWWWWWWWW WWWWWWWWWWWWWWW
WW WWWW WWWWWWWWW WWWWWWWWWWWWWWWW WWWWWWWWW WWWWWWWWWWWWWWW
WW WWWW WWWWWWWWW WWWWWWWWWWWWWWWW WWWWWWWWW WWWWWWWWWWWWWWW
WW                           J                            WW
WWWWWWW WWWWWWWWW WWWWWWWWWWWWWWWW WWWWWWWWW WWWWWWWWWWWW WW
WWWWWWW WWWWWWWWW WWWWWWWWWWWWWWWW WWWWWWWWW WWWWWWWWWWWW WW
WWWWWWW WWWWWWWWW WWWWWWWWWWWWWWWW WWWWWWWWW WWWWWWWWWWWW WW
WWWWWWW WWWWWWWWW WWWWWWWWWWWWWWWW WWWWWWWWW WWWWWWWWWWWW WW
WWWWWWW WWWWWWWWW WWWWWWWWWWWWWWWW WWWWWWWWW WWWWWWWWWWWW WW
WWS                                                       WW
WWWWWWW WWWWWWWWW WWWWWWWWWWWWWWWW WWWWWWWWW WWWWWWWWWWWWWWW
WWWWWWW WWWWWWWWW WWWWWWWWWWWWWWWW WWWWWWWWW WWWWWWWWWWWWWWW
WWWWWWW           WWWWWWWWWWWWWWWW           WWWWWWWWWWWWWWW
WWWWWWWWWWWWWWWWWWWWWWWWWWWWWWWWWWWWWWWWWWWWWWWWWWWWWWWWWWWW
WWWWWWWWWWWWWWWWWWWWWWWWWWWWWWWWWWWWWWWWWWWWWWWWWWWWWWWWWWWW