WWWWWWWWWWWWWWWWWWWWWWWWWWWWWWWWWWWWWWWWWWWWWWWWWWWWWWWWWWWW
W        WWWW  WWWWW   WWWW                                W
W    R   WWWW  WWWWW   WWWW                                W
W        H         H   WWWW                        R       W
W        WWWW  WWWWW   WWWW                                W
W  R     WWWW  WWWWW   WWWW                                W
W        WWWW  WWWWW   WWWW         R                      W
W        WWWW  WWWWW                               J       W
W      R WWWW  WWWWW   WWWW                                W
W        WWWW  WWWWW   WWWW                                W
W        WWWW  WWWWWWWWWWWW                R               W
W        WWWW  W          W                                W
W     R  WWWW  W WWWWWWWW W                                W
W        WWWW  W W      W W                                W
W        WWWW  W W      W WWWWWWHWWWWWWWWWW         R      W
W   R    WWWW  W W      W                 W                W
W        WWWW  W W   R  WWWWWWWWHWWWWWWWW WWW           WWWW
W        WWWW  W W                      W WWWW         WWWWW
W  R     WWWW  W W                      W WWWWW       WWWWWW
W        WWWW                             WWWWWW     WWWWWWW
W      R WWWW                   R         WWWWWWW   WWWWWWWW
W        WWWW  W W     R                W WWWWWWWW WWWWWWWWW
W        WWWW  W W                      W WWWWWWWW WWWWWWWWW
W        WWWWWWW W                      W WWWWWWWW WWWWWWWWW
W        WM M    W                      W WWWWWWWWHWWWWWWWWW
W        W WWWWWWW          R           W                  S
W   R    WMWWWWWWW                      WWWWWWWWWWWWWWWWWWWW
W        W WWWWWWW                                 WWWWWWWWW
W        WTWWWWWWW                                 WWWWWWWWW
WWWWWWWWWWWWWWWWWWWWWWWWWWWWWWWWWWWWWWWWWWWWWWWWWWWWWWWWWWWW