WWWWWWWWWWWWWWWWWWWWWWWWWWWWWWWWWWWWWWWWWWWWWWWWWWWWWWWWWWWW
W        WWWW  WWWWW   WWWW                                W
W    R   WWWW  WWWWW   WWWW                                W
W        H         H   WWWW                        R       W
W        WWWW  WWWWW   WWWW                                W
W  R     WWWW  WWWWW   WWWW                                W
W        WWWW  WWWWW   WWWW         R                      W
W        WWWW  WWWWW   H                                   W
W      R WWWW  WWWWW   WWWW                                W
W        WWWW  WWWWW   WWWW                                W
W        WWWW  WWWWWWHWWWWW                R               W
W        WWWW  W          W                                W
W     R  WWWW  W WWWWHWWW W                                W
W        WWWW  W W      W W                                W
W        WWWW  W W      W WWWWWWWWHWWWWWWWW         R      W
W   R    WWWW  W W      W                 W                W
W        WWWW  W W   R  WWWWWWWWWWHWWWWWW WWW           WWWW
W        H     H H                      W WWWW         WWWWW
W  R     WWWW  W W                      W WWWWW       WWWWWW
W        WWWW  W W                      W WWWWWW     WWWWWWW
W      R WWWW  W W              R       H WWWWWWW   WWWWWWWW
W        WWWW  W W     R                W WWWWWWWW WWWWWWWWW
W        WWWW  W W                      W WWWWWWWW WWWWWWWWW
W        WWWWHWW W                      W WWWWWWWW WWWWWWWWW
W        WM M    H                      W WWWWWWWWHWWWWWWWWW
W        W WWWWWWW          R           W                  S
W   R    WMWWWWWWW                      WWWWWWWWWWHWWWWWWWWW
W        W WWWWWWW                                 WWWWWWWWW
W        WMWWWWWWW                                 WWWWWWWWW
WWWWWWWWWW WWWWWWWWWWWWWWWWWWWWWWWWWWWWWWWWWWWWWWWWWWWWWWWWW
