WWWWWWWWWWWWWWWWWWWWWWWWWWWWWWWWWWWWWWWWWWWWWWWWWWWWWWWWWWWW
WWWWWWWWWWWWWWWWWWWWWWWWWWWWWWWWWWWWWWWWWWWWWWWWWWWWWWWWWWWW
WWWWWWWWWWWWWWWWWWWWWWWWWWWWWWWWWWWWWWWWWWWWWWWWWWWWWWWWWWWW
WWWWWWWW                 WWWWWWW                 WWWWWWWWWWW
WWWWWWWW WWWWWWWWWWWWWWW WWWWWWW WWWWWWWWWWWWWWW WWWWWWWWWWW
WWWWWWWW W             W WWWWWWW W             W WWWWWWWWWWW
WWWWWWWW W        R    W WWWWWWW W             W WWWWWWWWWWW
WWWWWWWW W      J      H WWWWWWW H   R         W WWWWWWWWWWW
WWWWWWWW W             H WWWWWWW H             W WWWWWWWWWWW
WWWWWWWW W             W WWWWWWW W       R     W WWWWWWWWWWW
WWWWWWWW W  R          W WWWWWWW W             W WWWWWWWWWWW
WWWWWWWW WWWWWW  WWWWWWW WWWWWWW WWWWWWW  WWWWWW WWWWWWWWWWW
WWWWWWWW                                                  SW
WWWWWWWWWWWWWWWHHWWWWWWW WWW WWW WWWWWWWHHWWWWWW WWWWWWWWWWW
W                                                WWWWWWWWWWW
WWWWWWWWWWWWWWWHHWWWWWWW WWW WWW WWWWWWWHHWWWWWWWWWWWWWWWWWW
WWWWWWWW                                         WWWWWWWWWWW
WWWWWWWW WWWWWW  WWWWWWW WWWWWWW WWWWWWW  WWWWWW WWWWWWWWWWW
WWWWWWWW W             W WWWWWWW W             W WWWWWWWWWWW
WWWWWWWW W             W WWWWWWW W         R   W WWWWWWWWWWW
WWWWWWWW W     R       W WWWWWWW W             W WWWWWWWWWWW
WWWWWWWW W             W WWWWWWW W             W WWWWWWWWWWW
WWWWWWWW W             H WWWWWWW H     R       W WWWWWWWWWWW
WWWWWWWW W             H WWWWWWW H             W WWWWWWWWWWW
WWWWWWWW W        R    W WWWWWWW W             W WWWWWWWWWWW
WWWWWWWW W             W WWWWWWW W             W WWWWWWWWWWW
WWWWWWWW WWWWWWWWWWWWWWW WWWWWWW WWWWWWWWWWWWWWW WWWWWWWWWWW
WWWWWWWW                 WWWWWWW                 WWWWWWWWWWW
WWWWWWWWWWWWWWWWWWWWWWWWWWWWWWWWWWWWWWWWWWWWWWWWWWWWWWWWWWWW
WWWWWWWWWWWWWWWWWWWWWWWWWWWWWWWWWWWWWWWWWWWWWWWWWWWWWWWWWWWW