WWWWWWWWWWWWWWWWWWWWWWWWWWWWWWWWWWWWWWWWWWWWWWWWWWWWWWWWWWWW
WWWWWWWWWWWWWWWWWWWWWWWWWWWWW     WWWWWWWWWWWWWWWWWWWWWWWWWW
WWWWWWWWWWWWWWW                   WWWWWWWWWWWWWWWWWWWWWWWWWW
WWWWWWWWWWWWWWW WWWWWWWWWWWWW     WWWWWWWWWWWWWWWWWWWWWWWWWW
WWWWWWWWWWWWWWW WWWWWWWWWWWWW     WWWWWWWWWWWWWWWWWWWWWWWWWW
WWWWWWWWWWWWWWW WWWWWWWWWWWWWWWHWWWWWWWWWWWWWWWWWWWWWWWWWWWW
WWWWWWWW                W              WWWWWWWWWWWWWWWWWWWWW
WWWWWWWW       R        W WWWWW WWWWWW WWWWWWWWWWWWWWWWWWWWW
WWWWWWWW                W W          W WWWWWWWWWWWWWWWWWWWWW
WWWWWWWWWWWWWWWWWWWWWWWWW W          W WWWWWWWWWWWWWWWWWWWWW
WWWWWWWWWWWWWWWWW    WWWW W          W WWWWWWWWWWWWWWWWWWWWW
S                    W    W          W   WWWWWWWWWWWWWM M MW
WWWWWWWWWWWWWWW W    W WWWW          WWW WWWWWWWWWWWWW WWWWW
WWWWWWWWWWWWWWW W    W W               W WWWWWWWWWWWWWMWWWWW
WWWWWWWWWWWWWWW W    W W               W WWWWWWWWWWWWW WWWWW
WWWWWWWWWWWWWWW W    W W      R        W WWWWWWWWWWWWW WWWWW
WWWWWWWWWWWWWWW W    W W               W WWWWWWWWWWWWW WWWWW
WWWWWWWWWWWWWWW W  R                     WWWWWWWWWWWWW WWWWW
WWWWWWWWWWWWWWW W    W W               W               WWWWW
WWWWWWWWWWWWWWW W    W W               WWWWWWWWWWWWWWWWWWWWW
WWWWWWWWWWWWWWW WWWWWW WWWWWWWW WWWWWWWWWWWWWWWWWWWWWWWWWWWW
WWWWWWWWWWWWWWW        WWWWWWWW WWWWWWWWWWWWWWWWWWWWWWWWWWWW
WWWWWWWWWWWWWWWWWWWWWWWWWWWWWWW WWWWWWWWWWWWWWWWWWWWWWWWWWWW
WWWWWWWWWWWWWWWWW                      WWWWWWWWWWWWWWWWWWWWW
WWWWWWWWWWWWWWWWW                      WWWWWWWWWWWWWWWWWWWWW
WWWWWWWWWWWWWWWWW     R      J         WWWWWWWWWWWWWWWWWWWWW
WWWWWWWWWWWWWWWWW                      WWWWWWWWWWWWWWWWWWWWW
WWWWWWWWWWWWWWWWW                      WWWWWWWWWWWWWWWWWWWWW
WWWWWWWWWWWWWWWWW                      WWWWWWWWWWWWWWWWWWWWW
WWWWWWWWWWWWWWWWWWWWWWWWWWWWWWWWWWWWWWWWWWWWWWWWWWWWWWWWWWWW
